Yugtun Qalarcaraq, Qaneryaraq -- Yup'ik Language
	Qalarcarat -- Dialects
		Yugtun, Yugcetun -- Yup'ik
			General Central
			Yukon
			Lower Yukon
			Norton Sound
			Upper Kuskokwim
			Bristol Bay
			Egegik
		Cugtun, Yugtun -- Cup'ik & Yup'ik of Hooper Bay & Chevak
		Cup'ig -- Nunivak Island
	Uyaquq -- Lloyd Nick [Helper Neck]
		Uyaqum Igaryarai -- Uyaquq's Orthography
Nunat Mer'et-llu Atrit -- Place Names For Land And Bodies Of Water
	Mer'et Atrit -- Place Names For Bodies Of Water
		Kuigpak -- Yukon River
		Kusquqvak -- Kuskokwim River
		Kiillaralliin -- Heart Lake
	Nunacuaraat Atrit -- Place Names For Villages
		Ungalaqliq -- Unalakleet
		Taciq -- St. Michael
		Tapraq -- Stebbins
		Qerrullik -- Kotlik
		Caniliaq -- Chaneliak
		Imangaq -- Emmonak
		Alarneq -- Alakanuk
		Nunam Iqua -- Nunam Iqua [Sheldon's Point]
		Asaacarsaq -- Mountain Village
		Negeqliq -- St. Mary's
		Negeqliim Painga -- Pilot Station
		Masserculleq -- Marshall
		Iqugmiut -- Russian Mission
		Paimiut -- Paimiut
		Ingrirraller -- Holy Cross
		Marayaarmiut -- Scammon Bay
		Naparyaarmiut -- Hooper Bay
		Cev'aq -- Chevak
		Niugtaq -- Newtok
		Kayalivik -- Kayalivik
		Tununeq -- Tununak
		Nunakauyaq -- Toksook Bay
		Negteḿiut -- Nightmute
		Mikuryaq -- Mekoryuk
		Cevv'arneq -- Chefornak
		Qipneq -- Kipnuk
		Kuigilnguq -- Kwigillingok
		Kangirnaq -- Kongiganak
		Ekvicuar -- Eek
		Tuntutuliaq -- Tuntutuliak
		Qinaq -- Qinaq
		Naparyarraq -- Napakiak
		Napaskiaq -- Napaskiak
		Kuiggayagaq -- Oscarville
		Nunapicuaq -- Nunapitchuk
		Kassigluq -- Kasigluk
		Atmaulluaq -- Atmautluak
		Mamterilleq -- Bethel
		Kuiggluk -- Kwethluk
		Akiacuar -- Akiachak
		Akiaq -- Akiak
		Tuulkessaaq -- Tuluksak
		Qalqaq -- Kalskag
		Anyaraq -- Aniak
		Curarpalek -- Chuathbaluk
		Napamiut -- Napaimiut
		Cellitmiut -- Sleetmute
		Kuinerraq -- Quinhagak
		Mamterat -- Goodnews Bay
		Arviiq -- Platinum
		Tuyuryaq -- Togiak
		Ingricuar -- Twin Hills
		Manuquutaq -- Manakotak
		Iyuussiiq -- Igushik
		Iquk -- Ekuk
		Curyung -- Dillingham
		Alaqnaqiq -- Aleknagik
		Uksurnarli -- Portage Creek
		Iquaq -- Ekwok
		Cetuyaraq -- New Stuyahok
		Qalirneq -- Kaliganek
		Nakneq -- Naknek
		Saguyaq -- Clark's Point
		Nanvarnarrlak -- Nanvarnarrlak
		Urucaraq -- Urucaraq
		Nunacuaq -- Nunacuaq
		Acacaryun -- Acacaryun
		Anchorage -- Anchorage
		Noatak -- Noatak
		Kotzebue -- Kotzebue
	Ingriq -- Mountain
Ellavut -- Weather, Climate
	Allrakum Ellalinqigutai -- Seasons
		Up'nerkaq, Upenerkaq -- Spring
		Uksuaq -- Fall
		Kiak -- Summer
		Uksuq -- Winter
	Ellaliuryaraq -- Predicting Weather
		Ellassuun -- Weather Device
	Ellam Cimillra -- Climate Change
	Ciku -- Ice
		Kianeq -- Naturally Occurring Holes in Ice
	Qanikcaq -- Snow
		Urugyaraa -- Melting
	Iraluq -- Moon, Month
	Akerta -- Sun
	Agyat -- Stars
	Nunavut -- Our Land
		Uqlaneq -- Pollution
			Neqet Cumacitartut -- Fish are Repulsed by Pollution
		Nunam Auluksaraa -- Taking Care of the Land
			Menuunani -- Pristine
		Nunam Ataniuryaraa -- Land Governance
	Ulerpak -- Flood
	Ellarrluk -- Good Weather Being Bad
	Qilagkun Sass'aq -- Measuring Time with the Sky
		Akerta -- Sun
		Iraluq -- Moon
Yuut -- People
	Ayagyuat -- Youth
	Tegganeq -- Elder
	Nukalpiaq -- Great Hunter
	Nengauk -- Son-in-law
	Elliraat -- Orphans
Ungungssit Mermiutaat-llu -- Land And Water Animals
	Neqa, Neqet -- Fish
		Can'giiq, Imangaq -- Blackfish
			Alungyaraat -- Blackfish Fries
		Neqpik -- Salmon
		Meluk, Imlauk -- Roe
		Luqruuyak, Eluqruuyak, Keggsuli, Cuukvak -- Pike
	Yaqulek, Yaqulget, Tengmiaq, Tengmiat -- Birds
		Qangqiiq -- Ptarmigan
		Ingtaq, Ingtat -- Molted Birds
	Ungungssit, Yuilqurmiutaat, Nunamiutaat -- Land, Wilderness Animals
		Tuntu -- Reindeer, Caribou
		Imarmiutaq -- Mink
		Kegluneq -- Wolf
		Cuignilnguq -- Otter
		Qanganaq -- Ground Squirrel
		Tan'gerliq -- Black Bear
		Taqukaq, Carayaq -- Brown Bear
		Qanganaq -- Ground Squirrel
		Tuntuvak -- Moose
		Tuntupik, Tuntupiaq -- Caribou
	Imarpigmiutaat, Unkumiutaat, Mermiutaat -- Marine Animals
		Maklak -- Bearded Seal
		Nayiq -- Ringed Seal
		Puga -- Surfaced Seal
		Cetuaq -- Beluga
		Issuriq -- Spotted Seal
	Piyagaq -- Baby Animal
Naunraat Atsat-llu -- Plants And Berries
	Atsat -- Berries
	Naunraat -- Plants
		Anuqetuliaraat -- Yarrows
		Quagciq -- Sourdock
		Uqviit, Enrilnguat -- Willows
	Canek, Can'get, Caranglluk, Evek -- Grass
		Tupigyaraq -- Grass Weaving
		Mingqaat -- Grass Baskets
		Taperrnaq -- Course Seashore Grass
		Iitaq -- Tall Cottongrass
		Kelugkaq -- Course Grass for Weaving Mats
		Issran -- Grass Backpack
		Kalngak -- Grass Bag for Fish
		Naqtat -- Grass Mats
		Ekiaq -- Inner Lining
	Naucetaat -- Crops
		Naucetaanek Enuqitellriit -- Crop Failure
Akluq, Aklut -- Clothing, Possessions
	Maqarqessaraq -- Weather Clothes
	Kass'artaat -- Manufactured Items
	Qaralit -- Adornments
		Nallunailkutet -- Family Crests
	Amiq, Qecik -- Skin, Hide
		Ivrucit -- Waterproof Skin Boots
		Amirak, Amiraq -- Waterproof Fish Skin Boots
			Neqairiyaraq -- Preparing Fish Skin for Use
	Allat -- Other Clothes
		Imarnin -- Seal Gut Rain Parka
Ukverput, Agayuliyaraq -- Spirituality
	Agayumayaraq, Agayumaciq -- Christianity
		Agayuviit -- Churches
			Moravian -- Moravian
			Kass'alugpiaq -- Russian Orthodox
		Agayulirtet -- Priests
		Qaneryaraq, Qaneryaraqegtaar -- Bible
		Anglluryaraq -- Baptism
		Piicak -- Prayer
	Ellam Yua, Cellam Yua, Cillam Cua -- Spirit Of The Universe
	Piunrillret, Yuunrillret, Tuqullret, Catairutellret -- Afterlife
	Angalkut, Angalkuut -- Shamans
		Tuunrat -- Spirit Helpers
		Unatellget -- Healing Hands
		Tuunriyaraq, Angalkiyaraq -- Shamanistic Acts, Rituals
		Umyuarrliqellriit -- Those with Malicious Intent
			Aniqlaarutet -- Curses
	Alangru, Aliurtuq -- Ghost, Haunting
		Qimugtet Elpegtauciatnek -- Dogs' Supernatural Sensitivity
	Aviukaryaraq -- Food And Water Offering
Nerangnaqsaraq, Yuungnaqsaraq -- Subsistence
	Pissuryaraq -- Hunting
		Qamigaryaraq -- Spring Seal Hunting
			Uurcaq -- Returning Seal Hunter with a Signaling Gaff
		Yaqulecuarteggun Elitnauryaraq -- Practicing with Small Birds
	Pingnatugyaraq -- Providing
	Neqsuryaraq -- Fishing
		Kuvyat -- Drift Nets
		Taluyat -- Fish Traps
		Qalut -- Dipnets
	Melqulegcuryaraq -- Trapping
	Makirayaraq -- Gathering
		Iqvaryaraq -- Picking Berries
			Tutmarpek'nani -- Do Not Step on Them
		Kayangussuq, Avuryaraq -- Egg Hunting
			Kayanguq -- Egg
		Pakissaagyaraq -- Gathering from Vole Caches
		Naumalriit Inerquutngulriit -- Plants Warned Against
		Cuassaat -- Edible Greens
	Calirpagyaraq -- Hard Work
	Up'nerkilleq -- Spring Camp
	Uksuilleq -- Winter Camp
	Neqlilleq, Neqlivik -- Fish Camp
	Neqkat Kenciksarait -- Reverence for Food Sources
		Quyakluki Ciuniurluki -- Gratefully Accept Them
		Ilakuat Neqerrluut Qimugtet Neqkait -- Leftover Dried Fish as Dog Food
	Upaketaaryaraq -- Nomadic Lifestyle
	Caanguararkanek Avuusqevkenaki -- Do Not Gather What Will Be Wasted
	Tekitarkaq Umyuaqerrlainallruat -- They Always Prepared for the Future
Neqkiuryaraq -- Food Preparation
	Keniryaraq, Egayaraq -- Cooking
		Assaliaq -- Frybread, Pancake
	Segyaraq, Cegyaraq -- Fish Cutting
		Akerciurcecuunaki -- Not Letting Them Stay in the Sun
		Piqertuutarpek'naki -- Do Not Chop Them with an Axe
	Kinerciriyaraq -- Drying
		Nakaculiyaraq -- Hanging Small Birds to Dry
	Puyurciyaraq -- Smoking
	Qemagciyaraq -- Storage
		Kumlivik -- Freezer
		Elagyat, Elliviit, Mamterat -- Food Caches
	Ak'allaciryaraq -- Fermenting
	Suluniyaraq, Culuniyaraq -- Salt Curing
	Pickling
	Akutaq -- Akutaq ("Eskimo Ice Cream")
		Tenguggluk -- Fish Liver Akutaq
		Qerpertaq -- Pike Egg Akutaq
		Tunuq -- Tallow
		Puya -- Moss Soaked in Seal Oil with Berries
	Ungangkengaita Auluksarait -- Taking Care of Catch
	Aulukumanrilnguut Assiirutarkauciat -- Neglected Food Will Spoil
	Neqallret -- Scraps
		Tutmarngailngurmun Ciqicarait -- Disposal Where People Won't Trod
		Pissuryarat Neqsuryarat-llu Nunaitnun Egtesqevkenaki -- Do Not Dispose of Them in Hunting or Fishing Areas
		Allragnillaat Kuignun Egteksaunaki -- Do Not Throw Year-Old Food into the River
	Uquq -- Oil, Fat
Anangnaqsaraq Yuilqumi -- Survival (Wilderness)
	Qercuaneq, Qercualleq -- Frostbite
	Kit'elleq -- Falling Into Water
		Pugtassuutet, Kit'essuutet -- Floatation Devices, Life Jackets
	Pellaalleq -- Getting Lost
	Neqkaitelleq -- Having No Food
	Meqsugyaraq -- Thirst
	Ayagayaraq -- Travel
		Ayakatalriani Upcaraq -- Preparation for Travels
			Taquat -- Provisions
	Ellaliurcuutet -- Rain Gear
	Pirtuk, Pirta -- Blizzard
		Uqisvik -- Shelter
			Qengaruk -- Snowbank
			Murak Kapulluku Ellvilisqelluku -- Stick a Staff in for Ventilation
		Uqrem Aarnarqucia -- The Danger of Leeward Sides
		Qanikcaam Acian Epsalngunarqucia -- Suffocating Under Snow
		Utetmun Nallunailkuciryaraq -- Marking the Homeward Direction
		Naqugun -- Belt
	Qerruyaraq -- Freezing to Death
		Teq'um Urumanarqucia -- Keeping Warm with Urine
		Qerruqatalriit Puqlamun Pivkenaki -- Do Not Put Hypothermic People Near Heat
	Nuussiq, Cavik, Uluaq -- Knife
Imarpik -- Ocean, Sea
	Imarpigmi Anangnaqsaraq -- Survival (Ocean)
		Elegcik -- Gaff
		Ket'garyaraq -- Waterproofing a Kayak with a Rain Parka
		Pugtautet -- Life Vests, Floatation Devices
Tuqu Naulluun-llu, Qenan-llu -- Death & Sickness
	Tungmagciyaraq -- Burial
		Qunguq -- Burial, Grave
	Cangerlak -- Pandemic, Epidemic
		Quserpak -- Tuberculosis (TB)
		Tuqurpalriit -- The Great Death (Measles, Influenza)
	Kaignaq, Piitnaq -- Time of Hunger, Need
		Enurnaq -- Scarcity
		Nallunailkutet -- Preceding Signs
		Angucaluq -- Late Summer
		Arnacaluq -- Early Summer
		Ellam Qupsaraa -- The World, Universe Cracks
		Ayuquciita Puglauciat -- Their Natures Showing
	Tuquiyaraq, Nepliayaraq -- Mourning
Aipangyaraq, Aipaqsaraq -- Marriage
	Uingyaraq -- How To Work With A Husband
		Nengaugicaraq -- Husband Marrying Into Another Village
	Nuliangyaraq, Nulirturyaraq -- How To Work With A Wife
		Nuliarkameng Akiliutait -- Brideswealth, Bride Price, Bride Token
		Ukurricaraq -- Wife Marrying Into Another Village
	Aipangyaraq -- Getting A Spouse
		Angayuqrita Cucukekaitnek Aipangyaraq -- Arranged Marriage
		Umyuallguteklutek -- Being in Harmony
	Avvucaraq -- Divorce
	Yagirayaram Inerquutngucia -- Admonishments Against Raising Hands
	Qingaryaraq -- Pregnancy
		Irniyaraq -- Childbirth
			Irnivkartet, Nayurtet -- Midwives
	Allaliuryaraq -- Infidelity
Qulirat, Quliraat & Qanemcit -- Legends & Stories
	Ak'allaat Qanemcit -- Old Stories
		Anguyallret -- Old Wars
	Ukaqvallaat Qanemcit -- Recent Stories
		Tunciuryaraq -- Reindeer Herding
			Nallunailkutet -- Brands
	Qulirat, Quliraat -- Legends
		Ircenrraat -- Legendary Little People [Mischievous]
			Cautaita Ciunerkiurutait -- Their Things Portend the Future
		Egacuayiit -- Legendary Little People
		Cingssiiget -- Legendary Little People [Benevolent]
	Carayiit -- Strange Creatures
Kass'artaat -- Manufactured Items, Western Things
	Kass'at Tekipailgata -- Before Western Contact
		Nepiaq, Enepiaq, Enpiaq -- Sod-house
			Qacarneret -- Walls
	Kass'at Tekiteqerraallratni -- Early Western Contact
		Yupiit (Allat-llu) Nunautait -- Native Allotment
		Elitnaurvikarraat -- Boarding Schools, First Schools
			Yugtun Qalartesqevkenaki -- Yup'ik Language Restrictions
		Tunciuryaraq -- Reindeer Herding
		Sun'aq -- Ship, Barge
		Levaat, Massiinat, Elliqeryarat -- Boat Motors
	Aklut -- Clothes, Possessions
	Elitnaurvik -- School
		Yugtun Kass'atun-llu Elitnauryaraq -- Bilingual Education
	Kipusviit -- Trading Posts, Stores
Pissuutet, Cassuutet, Piliat, Saskut, Ayagassuutet -- Tools, Crafts, Weapons
	Cassuutet Saskut, Caskut -- Tools
		Ayaruq -- Walking Stick, Cane, Staff
		Cikuliurun, Tugeq -- Ice Spud, Ice Pick, Ice Chisel
		Negaq -- Snare, Trap
		Naneryaq -- Deadfall Trap
		Kapkaanaq -- Conibear, Steel Trap
		Taluyaq -- Fish Trap
			Can'giircuun -- Blackfish Trap
			Imarmiutarcuun -- Mink Trap
			Cuignilngurcuun -- Land Otter Trap
		Qanikciurun -- Shovel
	Piliat -- Handmade Crafts
	Saskut, Caskut -- Weapons
		Narulkaq -- Spear
	Ayagassuutet -- Transportation
		Qimugta -- Dog
			Qimugciryaraq -- Dog Mushing
		Snuukuuq -- Snowmachine, Snowgo, Snowmobile
		Qayaq -- Kayak
		Egelrun -- Canoe
		Angyaq -- Boat
	Tupigyaraq -- Grass Weaving
	Murak -- Wood
		Canaryaraq, Canayaraq -- Wood Carving
		Equgtaryaraq -- Gathering Wood
	Mingqaat -- Grass Baskets
	Teq'icilleq, Teq'iciraq -- Aged Urine
		Teq'iciriyaraq -- Aging Urine
Naanguat Aquiyarat-llu -- Toys & Games
	Irniaruat, Inuguat -- Dolls
	Airraq -- String Games
	Yaaruin -- Story Knife
	Naumalriit Enenguat -- Households Made of Plants
Ukverput -- Traditional Beliefs
	Elluatuuyarat -- Virtues
	Cingumalleq -- Encouragement
	Aarcirtuutet -- Warnings, Rules
		Qavam Qessam-llu Pikaitnarquciak -- Sleep and Laziness Lead to Destitution
		Akusrarun -- Mischief, Misconduct
			Nunalgutkenrilkemeggnun Nallunailuciit -- Being Widely Known
		Aipangvailegmeng Akusrarcaraq -- Premarital Sex
		Qanrucunailnguut -- Those Who Don't Heed Advice
			Unguvamayuitut -- They Don't Live Long
		Cacetulriim Arenqiallugtellerkaa -- Misfortune from Overconfidence
		Cigyak -- Split Spruce Blocking Door During Instruction
		Caniqerrilin, Caniqerrilitaq -- Woven Grass Belt Blocking Door During Instruction
		Anelria Taquilluku -- Giving Fate for One Who Goes Out
		Nakriarucaraq -- Losing Hunting Prowess
			Angutet Iqairarkait Allakarluki -- Separate Men's Laundry
	Piciryaraput -- Customs
		Merr'icaraq -- Giving Water To Animals
	Qanruyutet, Qaneryarat -- Traditional Wisdom, Wise Words
		Piciuyaraq -- Truthfulness
		Qigcikiyaraq -- Respect
			Qantamitun Pitarrluku -- As Much as One's Own Bowl
		Umyuartuyaraq -- Being Sensible
		Maligtaqustiin Yuunertutucia -- Those Who Heed Advice Live Long
			Keggukarangelria -- One So Old They Grow a New Set of Teeth
			Ciunerkaqegciarkauciat -- How They Will Have a Good Future
			Cakviussiyaagngaitut -- They Won't Struggle Too Much
			Elluarrluni Yuuciquq -- One Will Live Well
		Qaskuit Ayuquciit-llu -- Appearance and Nature
		Yuut Ataucimek Qanruyutengqertut -- Yup'ik Wisdom is the Same Everywhere
		Cuqyucirluteng Qanruciaqluteng -- Teaching Through Metaphors
		Qalarutesteteng Murilkelluki -- Observe Instructors Intently
	Alerquutet, Ayuqucirtuutet -- Instructions
		Maligtaquyaraq, Niisngayaraq -- Obedience
		Neryaraq -- Eating Habits
		Neqem, Neqkam Uqlautenritlkerkaa -- Not to Make a Mess with Food, Food Sources
		Qessaicaraq -- Not Being Lazy
		Enem Ilua Carrirturyaraa -- Keeping the House Clean
			Uqlam Yugmun Nepucuilucia -- Dirt Doesn't Stick to People
		Nunat Mer'et-llu Elisngaluki -- Know the Land and Water
		Tangvagluteng Elicungcaryaraq -- Learning through Observation
		Cauryaraq -- Keeping Busy, Doing Chores
			Calrunani Unguvamaniartuq -- To Live a Long and Healthy Life
		Anelriani Ellam Qukaa Tangerrluku -- Look at the Center of the Universe When Going Out
		Qanminek Mulngaksaraq -- Careful with Words
		Eneteng Uitanqegcinarqevkarluki -- Keep Your Houses Peaceful
		Piqrartanrilnguut Ikayurluki -- Help the Decrepit
		Ikayuqengyaraq -- Helping Others
			Erneq Aipirluku -- Living Another Day
		Ayallerkateng Nallunaitesqelluki -- To Make Travel Plans Known
	Eyagyaraq -- Abstinence Practices, Taboos
		Agleryaraq -- Menstruation
			Aglenraraq -- First Year of Menstruation
				Aqumgayaraq -- Abstinence During First Year of Menstruation
		Essuicaraq -- Spiritual Cleanliness
	Yuuyaraq -- Way Of Life
		Ellangyaraq -- Becoming Aware [Childhood]
	Kencikiyaraq -- Reverence
		Nuna Meq-llu Kenciklukek -- Revere Land and Water
		Kencikumanrilnguut Nangtuut -- Disrespected Food Sources Deplete
	Kenkiyaraq -- Showing Love
		Kenkucaraq -- Loving Each Other
	Kevgiurturyaraq -- Serving Others
		Akingellerkani Umyuaqevkenaku -- Do Not Expect Payment
		Menuurcuitut -- They Don't Become Impure
	Naklekiyaraq -- Compassion
	Inerquutet -- Admonishments
		Teglegyaraq -- Stealing
		Assiilkiurluteng Neresqevkenaki -- Do Not Dislike Food
		Qessakiluteng Neresqevkenaki -- Do Not Reject Food
		Akinauresqevkenaki -- Do Not Retaliate
		Qessayaraq -- Laziness
			Kaigasteńgurciiqut -- They Will Become Beggars
		Ellminek Ataneqsaraq, Umyugiuryaraq -- Being Self-Interested
		Nuyavvliisqevkenaki -- Keep Hair Kempt
		Erurirraarluteng Neq'liuryaraq -- Handle Food with Clean Hands
		Qumaqicaraq -- Sex Craze
		Nepaunani Yuuyaraq -- Living without Commotion
		Quyigingnaqsaraq -- Pride
		Kiuyaraq, Kiutaaryaraq -- Talking Back
		Tan'gaurluut Nasaurluut-llu Allakarluteng -- Boys and Girls Separate
		Eyurucaraq -- Defending Children
			Iqlungarituut -- They Become Liars
		Yuut Nalluatni Tegucaraq -- Taking Things Without Permission
		Iqluyaraq, Iqluquyaraq, Iqlungaryaraq -- Lying
		Aatailnguut -- Illegitimate Children
		Yuilqumi Neplirasqevkenaki -- Do Not Be Noisy in the Wilderness
			Arenqiallugeskuneng Neplirasqelluki -- Only Make Noise When in Trouble
	Takaqiyaraq -- Respect
		Angayuqateng Takaqluki -- Respect Your Parents
	Ciunerkiullret -- Future Predictions
		Ellam Iquklitlerkaa -- The End of the World
		Yuut Cimillerkaat -- People Will Change
		Ellarrluk -- Bad Weather
	Eyat, Eyaryaraq -- Tattoos, Tattooing
		Tamlurutet -- Women's Chin Tattoos
		Anguyalriani Yugtellriit -- Kills During War
	Asgurayullrunriluciat -- They Didn't Doubt Traditional Knowledge
Kalukat -- Celebrations, Gatherings
	Kevgiq, Kevgiryaraq -- Messenger Feast
		Kassiyuq -- Kevgiq Dance Festival
	Yuraq -- Yup'ik Dance, Dancing
		Yurarpalriit -- Dance Festivals
		Yuarun -- Song
			Anqaraun -- Victory Song
		Kegginaquq -- Mask
		Cauyaq -- Drum
			Yuulak -- Pair of Ceremonial Drums
		Nerukaraat -- Ceremonial Bowls of Food
	Nakaciuryaraq -- Bladder Festival
		Nakacuut -- Bladders
	Avgarutaaryaraq -- Invitation Contest
	Ingulagyagaq -- Ingulak Festival
	Uqiquryaraq -- Seal Party
	Pitqerraallret -- First Catches
	Itruka'ar -- Inviting-In Feast
	Kass'artaat -- Western Holidays
		Slaaviq -- Russian Christmas
		Alussistuaq -- Christmas
		Quyayaraq -- Thanksgiving
		Agnguaryaraq -- Western Dancing
Ilaliuryaraq -- Social Structure
	Ciuniuryaraq -- Welcoming Guests
	Qasgiq, Qaygiq -- Community or Men's House
		Maqi -- Steambath, Fire Bath
	Nepiaq -- Sod-house
	Ilakucaraq, Ilakellriit, Ilakelriit -- Family
		Tungayiit, Tungelqut -- Relatives
	Qanertet, Qanrucistet -- Traditional Instructors
	Ilaliuryaraq -- Socializing
	Nunat Ancitullratnek -- How Villages Exiled Members
Calricaraq -- Health & Wellness
	Qingaryaraq -- Pregnancy
		Irnicualleq -- Miscarriage
		Irniyaraq -- Giving Birth
	Anglicarillerkaq, Tukercaryaraq -- Child Rearing
		Yagiravkenaki -- Do Not Raise a Hand Against Them
		Qanpautevkenaki -- Do Not Shout at Them
		Ceńirutevkenaki -- Do Not Take Them to Others' Houses
	Auluksaraq -- Taking Care
	Ellminek Tuqutellerkaq -- Suicide
	Taangaq -- Alcohol
	Naulluun, Qenan, Nangtequn -- Sickness
		Pelqevkenaki Ikayurluki -- Help Them Without Fear of Spread
	Kuingirrluk -- Marijuana
	Umyuam Calritlerkaa -- Mental Health
		Qilnganeryaraq -- Grief
	Nernerrluut -- Food with Adverse Effects
		Ilussaqercaraq -- Food Poisoning
	Piunrissiyaayuitellrat Naulluussiyaayuunateng-llu -- Fewer Death and Sickness
	Yuungcarviit -- Clinics & Hospitals
	Iinrut -- Medicine
		Kass'artaat -- Western Medicine
			Tabasco -- Tabasco Sauce
		Yugtaat -- Yup'ik Remedies
			Teq'uq -- Urine
			Caqlaq -- Rosewort
			Uquq -- Seal Oil
			Atsaruaq -- False Chamomile
			Caiggluk, Qanganaruaq, Naunerrluk -- Wormwood
Qalartellret Atrit -- Names of Speakers
	INSERTELDERSHERE
Allat -- Uncategorized
	Yuartet -- Search And Rescue
	Yup'ik Nation
	Neq'liurtet, Yaquleyagiurtet, Kayanguyagiurtet -- Fish and Game, Fish and Wildlife